W,W,W,W,W,W,W,W
W,BR,R,R,DR,R,D,W
W,W,W,W,D,W,D,W
W,D,L,L,L,W,D,W
W,D,W,W,W,D,L,W
W,R,D,W,W,D,W,W
W,W,D,W,D,LR,R,E
W,E,L,L,L,W,W,W
