W,W,W,W,W,W,W,W,W,W,W,E,W
W,BR,R,R,DR,R,D,W,W,W,W,U,W
W,W,W,W,D,W,D,W,W,W,R,U,W
W,D,L,L,L,W,D,W,W,W,U,W,W
W,D,W,W,W,D,LR,R,R,R,U,L,W
W,R,D,W,W,D,W,W,W,W,W,U,W
W,W,D,W,D,LR,R,R,R,R,R,U,W
W,E,L,L,L,W,W,W,W,W,W,W,W
